N<<<<<<<<<<S<<<<<<<<<<<N
v<<<<<<<<<<S<<<<<<<<<<<^
vv####vv#SS####vv#####^^
vv####vv#^^####vv#####^^
vv####vv#^^####vv#####^^
vv####vv#^^####SS#####^^
vv<<<<vv#^^<<<<<<S<<<<^^
vv<<<<vv#^^<<<<<<S<<<<^^
vv####vv#^^####vv#####^^
vv####vv#^^####vv#####^^
vv####vv#^^####vv#####^^
SS####vv#^^####vv#####^^
vvS<<<<<<<<<<<<<<<<<<<<<
vvS<<<<<<<<<<<<<<<<<<<<<
vv###vv###^^##########^^
vv>>>>>>>>>>>>>>>>>>>S^^
vv>>>>>>>>>>>>>>>>>>>S^^
vv####vv#^^####vv#####SS
vv####vv#^^####vv#####^^
vv####vv#^^####vv<<<<<^^
vv####vv#^^####vv#####^^
vv####vv#^^####vv#####^^
vv####SS#^^####SS#####^^
v>>>>S>>>>>>>>S>>>>>>>^^
N>>>>S>>>>>>>>S>>>>>>>>N