O<<<<<<<<<<<<<<<<s<<<<<<<<<<<O
vOOOOOOOOOOOOOOOOsOOOOOOOOOOOO
vO##O###O###vO#SS###########^O
vO##O###O###vO#^O<<<<<<<<<<<^O
vOOOOOOOOOOOvO#^OOOOOOOOOOOO^O
vO##O#O#O#O#vO#^O###########^O
vO##O#O#O#O#vO#^O>>>>>>>>>>>^O
vOOOOOOOOO<vO#^OOOOOOOOOOOOO^O
vO##O#####O#vO#^O####vO#####^O
vO>>>>>>>>O>vO#^O####vO#####^O
vO##S#####O#vO#^O####SS#####^O
vO<<<s<<<<<<<<<<<<<<<<<s<<<<^O
vOOOOsOOOOOOOOOOOOOOOOOsOOOO^O
vO#########vO###^O##########^O
vO#########vO###^O##########^O
vO#########vO###^O##########^O
vO>>>s>>>>>>>>>>>>>>>>>>>>>s^O
vOOOOsOOOOOOOOOOOOOOOOOOOOOs^O
vO#vO#SS####vO#^O####vO#####SS
vO#vO#^O####vO#^O####vO#####^O
vO#vO#^O####vO#^O####vO#####^O
vO#vO#^O####vO#^O####vO#####^O
vO#vO#^O<<<<vO<^O<<<<vO<<<<<^O
vO#vO#^OOOOOvOO^OOOOOvOOOOOO^O
vO#vO#^O####vO#^O####vO#####^O
vO#vO#^O####vO#^O####vO#####^O
vO#vO#^O####vO#^O####vO#####^O
vO#vO#^O####SS#^O####SS#####^O
v>>>>>>>>>>s>>>>>>>>s>>>>>>>^O
OOOOOOOOOOOsOOOOOOOOsOOOOOOOOO