v<<<<<<<<<<S<<<<<<<<<<<^
v<<<<<<<<<<S<<<<<<<<<<<^
vv####vvASS####vv#####^^
vv####vvA^^####vv#####^^
vv####vvA^^####vv#####^^
vv####vvA^^####SS#####^^
vv<<<<vvA^^<<<<<<S<<<<^^
vv<<<<vvA^^<<<<<<S<<<<^^
vv####vvA^^####vv#####^^
vv####vvA^^####vv#####^^
vv####vvA^^####vv#####^^
SS####vvA^^####vv#####^^
vvS<<<<<<<<<<<<<<<<<<<<<
vvS<<<<<<<<<<<<<<<<<<<<<
vvAAAvvAAA^^##########^^
vv>>>>>>>>>>>>>>>>>>>S^^
vv>>>>>>>>>>>>>>>>>>>S^^
vv####vv#^^####vv#####SS
vv####vv#^^####vv#####^^
vv####vv#^^####vv<<<<<^^
vv####vv#^^####vv#####^^
vv####vv#^^####vv#####^^
vv####SS#^^####SS#####^^
v>>>>S>>>>>>>>S>>>>>>>^^
>>>>>S>>>>>>>>S>>>>>>>>>