v<<<<<<<<<<<<<<<<s<<<<<<<<<<<<
vv<<<<<<<<<<<<<<<s<<<<<<<<<<<^
vv##^###^###vvASS###########^^
vv##^###^###vvA^^<<<<<<<<<<<^^
vv>>>>>>>>>>vvA^^<<<<<<<<<<<^^
vv##v#vA^AvAvvA^^###########^^
vv##v#vA^AvAvvA^^>>>>>>>>>>>^^
vv<<<<<<<<v<vvA^^>>>>>>>>>>>^^
vvAAvAAAvAvvA^^####vv#####^^
vv>>>>>>>>v>vvA^^####vv#####^^
vvS#####v#vv#^^####SS#####^^
vv<<<s<<<<<<<<<<<<<<<<<s<<<<^^
vv<<<s<<<<<<<<<<<<<<<<<s<<<<^^
vv#########vv###^^##########^^
vv#########vv###^^##########^^
vv#########vv###^^##########^^
vv>>>s>>>>>>>>>>>>>>>>>>>>>s^^
vv>>>s>>>>>>>>>>>>>>>>>>>>>s^^
vv#vv#SS####vv#^^####vv#####SS
vv#vv#^^####vv#^^####vv#####^^
vv#vv#^^####vv#^^####vv#####^^
vv#vv#^^####vv#^^####vv#####^^
vv#vv#^^<<<<vv<^^<<<<vv<<<<<^^
vv#vv#^^<<<<vv<^^<<<<vv<<<<<^^
vv#vv#^^####vv#^^####vv#####^^
vv#vv#^^####vv#^^####vv#####^^
vv#vv#^^####vv#^^####vv#####^^
vv#vv#^^####SS#^^####SS#####^^
v>>>>>>>>>>s>>>>>>>>s>>>>>>>^^
>>>>>>>>>>>s>>>>>>>>s>>>>>>>>^